step,type,amount,nameOrig,oldbalanceOrg,newbalanceOrig,nameDest,oldbalanceDest,newbalanceDest
126,TRANSFER,5245375.3,C823324093,5245375.3,0.0,C1906616566,0.0,0.0
126,CASH_OUT,5245375.3,C1652591304,5245375.3,0.0,C1873104472,0.0,5245375.3
126,TRANSFER,1244037.74,C2133606495,1244037.74,0.0,C1015051610,0.0,0.0
126,CASH_OUT,1244037.74,C798134746,1244037.74,0.0,C303070069,0.0,1244037.74
126,TRANSFER,938288.58,C164359824,938288.58,0.0,C1021865689,0.0,0.0
126,CASH_OUT,938288.58,C1870394283,938288.58,0.0,C1006464744,0.0,938288.58
